R   1200    680
NO ./textures/muro.xpm
SO ./textures/muro.xpm
WE ./textures/muro.xpm
EA ./textures/muro.xpm

S ./textures/duckwithknife.xpm
C 255,200,160
F 122,122,122

111111111111111111111111111111111
100000000011000000000000000000001
101100000111000000000000000000001
10010000000000000000000N00200001
111111111011000001110000000000001
100000000011000001110111110111111
11110111111111011100000010001
11110111111111011101010010001
11000000110101011100000010001
10000000000000001100000010101
10000000000000001101010010001
1100000111010101111101111000111
11110111 1110101 101111010001
11111111 1111111 111111111111