R 1080 720
C 135,206,235
F 128,128,128
NO textures/libft-1.xpm
SO textures/ntwt-1.xpm
EA textures/printf-1.xpm
WE textures/gnline-1.xpm
B textures/skybox_tree.xpm
S textures/ghost.xpm

                                         11111
                                        11020111111111
11111111111111111                       1100000000000111111
10000000000000001111111111111111111111111102002002000000W01
10200000200000200000000000000000000000000000000000000111111
100000000000000011111111111111111001111111111111011111
10002000200020001               1001           101
10000000000000001               1001           101111111111111111
10202020002020201               1001           100000000000000001
10000000000000001           111110011111       111111111111111101
10002000200200001           100000000001                      101
10000000000000001           100000000001                      101
10200000200002001111111111111000200200011111111111111111111111101    1111111111111
10000000000000000000000000000000000000000000000000000000000000001    1000000200001
11111011111111111111121111111000200200011111111211111111111111101    1002000000201
    101             101     100000000001      101             10111111000000200001
11111011111111111   101     100000000001      101             10000000000020002001
10000000000000001   101     111110011111      101             10111111000000000021
10200000200000201   101         1001          101             101    1111110111111
10000000000000001111121111111111100111111111111211111111111111101         101
10002000200020000000000000000000000000000000000000000000000000001         101
10000000000000001111111111111111111110111111111111111111111111111         101
10202020002020201                   101                                   101
10000000000000001111111111111111111110111111111111111111111111111111111111101
10002000200200000000000020000000000000000000000000020000000000000000000000001
10000000000000000000000000000000000000020000000000000000000000000200000000001
10200000200002001111111111121111111211111112111111121111111211111112111111121
10000000000000001         111     111     111     111     111     111     111
11111111111111111