R 1080 720
NO ./textures/a.xpm
SO ./textures/b.xpm
EA ./textures/c.xpm
WE ./textures/d.xpm
S ./textures/e.xpm
C ./textures/f.xpm
F ./textures/f.xpm

        1111111111111111111111111
        1000000000110000000000001
        1011000001110000002000001
        10010000000000000000N0001
111111111011000001110000000000111
1000000111000001110111111111111
11111111 1111111 111111111111