        1111111111111111111111111
        1001000000000000000000001
111111111011000001110000000000001
100000000011000001110111111111111
11000001110101011111011110N0111
11111111 1111111 111111111111