  111111
11100001
10000011
1111111