  111111
22222222
33333333
44444